"a" = (/turf/floor/wasteland,/area)
"b" = (/turf/wall/concrete,/area)
"c" = (/turf/floor/wood,/turf/spawn,/area)
"d" = (/obj/lamp,/turf/floor/wood,/area)
"e" = (/turf/floor/grass,/area)
"f" = (/mob/living,/turf/floor/wood,/area)
"g" = (/obj/item/solErup,/turf/floor/wood,/area)
"h" = (/turf,/area)
"i" = (/turf/structure/lobby,/area)
"j" = (/turf/floor/wood,/area)

(1,1,1) = {"
eeeeeeeeeeeeeeeeeeeeeeeeeeeeeeeeeeeeeeeeeeeeeeeeee
eeeeeeeeeeeeeeeeeeeeeeeeeeeeeeeeeeeeeeeeeeeeeeeeee
eeeeeeeeeeeeeeeeeeeeeeeeeeeeeeeeeeeeeeeeeeeeeeeeee
eeeeeeeeeeeeeeeeeeeeeeeeeeeeeeeeeeeeeeeeeeeeeeeeee
eeeeeeeeeeeeeeeeeeeeeeeeeeeeeeeeeeeeeeeeeeeeeeeeee
eeeeeeeeeeeeeeeeeeeeeeeeeeeeeeeeeeeeeeeeeeeeeeeeee
eeeeeeeeeeeeeeeeeeeeeeeeeeeeeeeeeeeeeeeeeeeeeeeeee
eeeeeeeeeeeeeeeeeeeeeeeeeeeeeeeeeeeeeeeeeeeeeeeeee
eeeeeeeeeeeeeeeeeeeeeeeeeeeeeeeeeeeeeeeeeeeeeeeeee
eeeeeeeeeeeeeeeeeeeeeeeeeeeeeeeeeeeeeeeeeeeeeeeeee
eeeeeeeeeeeeeeeeeeeeeeeeeeeeeeeeeeeeeeeeeeeeeeeeee
eeeeeeeeeeeeeeeeeeeeeeeeeeeeeeeeeeeeeeeeeeeeeeeeee
eeeeeeeeeeeeeeeeeeeeeeeeeeeeeeeeeeeeeeeeeeeeeeeeee
eeeeeeeeeeeeeeeeeeeeeeeeeeeeeeeeeeeeeeeeeeeeeeeeee
eeeeeeeeeeeeeeeeeeeeeeeeeeeeeeeeeeeeeeeeeeeeeeeeee
eeeeeeeeeeeeeeeeeeeeeeeeeeeeeeeeeeeeeeeeeeeeeeeeee
eeeeeeeeeeeeeeeeeeeeeeeeeeeeeeeeeeeeeeeeeeeeeeeeee
eeeeeeeeeeeeeeeeeeeeeeeeeeeeeeeeeeeeeeeeeeeeeeeeee
eeeeeeeeeeeeeeeeeeeeeeeeeeeeeeeeeeeeeeeeeeeeeeeeee
eeeeeeeeeeeeeeeeeeeeeeeeeeeeeeeeeeeeeeeeeeeeeeeeee
eeeeeeeeeeeeeeeeeeeeeeeeeeeeeeeeeeeeeeeeeeeeeeeeee
eeeeeeeeeeeeeeeeeeeeeeeeeeeeeeeeeeeeeeeeeeeeeeeeee
eeeeeeeeeeeeeeeeeeeeeeeeeeeeeeeeeeeeeeeeeeeeeeeeee
eeeeeeeeeeeeeeeeeeeeeeeeeeeeeeeeeeeeeeeeeeeeeeeeee
eeeeeeeeeeeeeeeeeeeeeeeeeeeeeeeeeeeeeeeeeeeeeeeeee
eeeeeeeeeeeeeeeeeeeeeeeeeeeeeeeeeeeeeeeeeeeeeeeeee
eeeeeeeeeeeeeeeeeeeeeeeeeeeeeeeeeeeeeeeeeeeeeeeeee
eeeeeeeeeeeeeeeeeeeeeeeeeeeeeeeeeeeeeeeeeeeeeeeeee
eeeeeeeeeeeeeeeeeeeeeeeeeeeeeeeeeeeeeeeeeeeeeeeeee
eeeeeeeeeeeeeeeeeeeeeeeeeeeeeeeeeeeeeeeeeeeeeeeeee
eeeeeeeeeeeeeeeeeeeeeeeeeeeeeeeeeeeeeeeeeeeeeeeeee
eeeeeeeeeeeeeeeeeeeeeeeeeeeeeeeeeeeeeeeeeeeeeeeeee
eeeeeeeeeeeeeeeeeebbbbbbbbbbeeeeeeeeeeeeeeeeeeeeee
eeeeeeeeeeeeeeebbbbbbbbbbbbbbbeeeeeeeeeeeeeeeeeeee
eeeeeeeeeeeebbbbbbbbjjjjjjjbbbbeeeeeeeeeeeeeeeeeee
eeeebeeeeebbbbbbbjjjjjjjjjjbbbbeeeeeeeeeeeeeeeeeee
jejjbbbebbbbbbjjjjjjjjjjjjjjbbbbeeeeeeeeeeeeeeeeee
jjjjjbbbbbbbjjjjjjjbbbjjjjjjjbbbeeeeeeeeeeeeeeeeee
jjjjjbbbbbjjjjjjjjjjbbbbjjjjjbbbeeeeeeeeeeeeeeeeee
jjjjjjjjbjjjjjjjjjjjjbbbjjjjjbbbeeeeeeeeeeeeeeeeee
jjjjjjjjjjjjjjjjjjjjjbbbjjjjjbbeeeeeeeeeeeeeeeeeee
jjjjjjjjjjjjbbbbbbjjjbbbjjjjjbbeeeeeeeeeeeeeeeeeee
jjbbbbbbbbbbbbbbbbbbbbbbjjjbbbbeeeeeeeeeeeeeeeeeee
jbbbbbbbbbbbbbbbbbbbbbbbjjbbjbbeeeeeeeeeeeeeeeeeee
bbbbbbbbbbbbaaajjjjjbbbbjjjjjbbeeeeeeeeeeeeeeeeeee
bbbbbbbjjbbbbjajdjjjjjbbjjjjjbbeeeeeeeeeeeeeeeeeee
bbjjjbbjdjjbbbajjjjjjjjjjjjjjbbeeeeeeeeeeeeeeeeeee
jjfdjbjjjjjjjjajaajjjjjjjjjjjbbeeeeeeeeeeeeeeeeeee
jjjjjjjjjjjjjjajjaajjjjbjjdjbbbeeeeeeeeeeeeeeeeeee
cjjjjjbgjjbbbjaaaaajjbbbbbbbbbbeeeeeeeeeeeeeeeeeee
"}

(1,1,2) = {"
hhhhhhhhhhhhhhhhhhhhhhhhhhhhhhhhhhhhhhhhhhhhhhhhhh
hhhhhhhhhhhhhhhhhhhhhhhhhhhhhhhhhhhhhhhhhhhhhhhhhh
hhhhhhhhhhhhhhhhhhhhhhhhhhhhhhhhhhhhhhhhhhhhhhhhhh
hhhhhhhhhhhhhhhhhhhhhhhhhhhhhhhhhhhhhhhhhhhhhhhhhh
hhhhhhhhhhhhhhhhhhhhhhhhhhhhhhhhhhhhhhhhhhhhhhhhhh
hhhhhhhhhhhhhhhhhhhhhhhhhhhhhhhhhhhhhhhhhhhhhhhhhh
hhhhhhhhhhhhhhhhhhhhhhhhhhhhhhhhhhhhhhhhhhhhhhhhhh
hhhhhhhhhhhhhhhhhhhhhhhhhhhhhhhhhhhhhhhhhhhhhhhhhh
hhhhhhhhhhhhhhhhhhhhhhhhhhhhhhhhhhhhhhhhhhhhhhhhhh
hhhhhhhhhhhhhhhhhhhhhhhhhhhhhhhhhhhhhhhhhhhhhhhhhh
hhhhhhhhhhhhhhhhhhhhhhhhhhhhhhhhhhhhhhhhhhhhhhhhhh
hhhhhhhhhhhhhhhhhhhhhhhhhhhhhhhhhhhhhhhhhhhhhhhhhh
hhhhhhhhhhhhhhhhhhhhhhhhhhhhhhhhhhhhhhhhhhhhhhhhhh
hhhhhhhhhhhhhhhhhhhhhhhhhhhhhhhhhhhhhhhhhhhhhhhhhh
hhhhhhhhhhhhhhhhhhhhhhhhhhhhhhhhhhhhhhhhhhhhhhhhhh
hhhhhhhhhhhhhhhhhhhhhhhhhhhhhhhhhhhhhhhhhhhhhhhhhh
hhhhhhhhhhhhhhhhhhhhhhhhhhhhhhhhhhhhhhhhhhhhhhhhhh
hhhhhhhhhhhhhhhhhhhhhhhhhhhhhhhhhhhhhhhhhhhhhhhhhh
hhhhhhhhhhhhhhhhhhhhhhhhhhhhhhhhhhhhhhhhhhhhhhhhhh
hhhhhhhhhhhhhhhhhhhhhhhhhhhhhhhhhhhhhhhhhhhhhhhhhh
hhhhhhhhhhhhhhhhhhhhhhhhhhhhhhhhhhhhhhhhhhhhhhhhhh
hhhhhhhhhhhhhhhhhhhhhhhhhhhhhhhhhhhhhhhhhhhhhhhhhh
bbbbbbbbbbbbbbbbbbbbbbbbhhhhhhhhhhhhhhhhhhhhhhhhhh
bbbbbbbbbbbbbbbbbbbbbbbbhhhhhhhhhhhhhhhhhhhhhhhhhh
bbbbbbbbbbbbbbbbbbbbbbbbhhhhhhhhhhhhhhhhhhhhhhhhhh
bbbbbbbbbbbbbbbbbbbbbbbbhhhhhhhhhhhhhhhhhhhhhhhhhh
bbbbbbbbbbbbbbbbbbbbbbbbhhhhhhhhhhhhhhhhhhhhhhhhhh
bbbbbbbbbbbbbbbbbbbbbbbbhhhhhhhhhhhhhhhhhhhhhhhhhh
bbbbbbbbbbbbbbbbbbbbbbbbhhhhhhhhhhhhhhhhhhhhhhhhhh
bbbbbbbbbbbbbbbbbbbbbbbbhhhhhhhhhhhhhhhhhhhhhhhhhh
bbbbbbbbbbbbbbbbbbbbbbbbhhhhhhhhhhhhhhhhhhhhhhhhhh
bbbbbbbbbbbbbbbbbbbbbbbbhhhhhhhhhhhhhhhhhhhhhhhhhh
bbbbbbbbbbbbbbbbbbbbbbbbhhhhhhhhhhhhhhhhhhhhhhhhhh
bbbbbbbbbbbbbbbbbbbbbbbbhhhhhhhhhhhhhhhhhhhhhhhhhh
bbbbbbbbbbbbbbbbbbbbbbbbhhhhhhhhhhhhhhhhhhhhhhhhhh
bbbbbbbbbbbbbbbbbbbbbbbbhhhhhhhhhhhhhhhhhhhhhhhhhh
bbbbbbbbbbbbbbbbbbbbbbbbhhhhhhhhhhhhhhhhhhhhhhhhhh
bbbbbbbbbbbbbbbbbbbbbbbbhhhhhhhhhhhhhhhhhhhhhhhhhh
bbbbbbbbbbbbbbbbbbbbbbbbhhhhhhhhhhhhhhhhhhhhhhhhhh
bbbbbbbbbbbbbbbbbbbbbbbbhhhhhhhhhhhhhhhhhhhhhhhhhh
bbbbbbbbbbbbbbbbbbbbbbbbhhhhhhhhhhhhhhhhhhhhhhhhhh
bbbbbbbbbbbbbbbbbbbbbbbbhhhhhhhhhhhhhhhhhhhhhhhhhh
bbbbbbbbbbbbbbbbbbbbbbbbhhhhhhhhhhhhhhhhhhhhhhhhhh
bbeeebbebbebebbbbbbbbbbbhhhhhhhhhhhhhhhhhhhhhhhhhh
bbebebebebebebbbbbbbbbbbhhhhhhhhhhhhhhhhhhhhhhhhhh
bbeebbeeebebebbbbbbbbbbbhhhhhhhhhhhhhhhhhhhhhhhhhh
bbebbbebebeeebbbbbbbbbbbhhhhhhhhhhhhhhhhhhhhhhhhhh
bbbibbbbbbbbbbbbbbbbbbbbhhhhhhhhhhhhhhhhhhhhhhhhhh
bbbbbbbbbbbbbbbbbbbbbbbbhhhhhhhhhhhhhhhhhhhhhhhhhh
bbbbbbbbbbbbbbbbbbbbbbbbhhhhhhhhhhhhhhhhhhhhhhhhhh
"}
